# Table to convert ROMAJI to HIRAGANA in Japanese.
#
# Format: {INPUT}\t{EMIT}[\t{REMAIN}]

a	あ
i	い
u	う
e	え
o	お

ka	か
ki	き
ku	く
ke	け
ko	こ

sa	さ
si	し
su	す
se	せ
so	そ

ta	た
ti	ち
tu	つ
te	て
to	と

na	な
ni	に
nu	ぬ
ne	ね
no	の

ha	は
hi	ひ
hu	ふ
he	へ
ho	ほ

ma	ま
mi	み
mu	む
me	め
mo	も

ya	や
yi	い
yu	ゆ
ye	いぇ
yo	よ

ra	ら
ri	り
ru	る
re	れ
ro	ろ

wa	わ
wi	ゐ
wu	う
we	ゑ
wo	を

ga	が
gi	ぎ
gu	ぐ
ge	げ
go	ご

za	ざ
zi	じ
zu	ず
ze	ぜ
zo	ぞ

da	だ
di	ぢ
du	づ
de	で
do	ど

ba	ば
bi	び
bu	ぶ
be	べ
bo	ぼ

pa	ぱ
pi	ぴ
pu	ぷ
pe	ぺ
po	ぽ

la	ぁ
li	ぃ
lu	ぅ
le	ぇ
lo	ぉ

lya	ゃ
lyi	ぃ
lyu	ゅ
lye	ぇ
lyo	ょ

xa	ぁ
xi	ぃ
xu	ぅ
xe	ぇ
xo	ぉ

xya	ゃ
xyi	ぃ
xyu	ゅ
xye	ぇ
xyo	ょ

kya	きゃ
kyi	きぃ
kyu	きゅ
kye	きぇ
kyo	きょ

gwa	ぐぁ
gwi	ぐぃ
gwu	ぐぅ
gwe	ぐぇ
gwo	ぐぉ

gya	ぎゃ
gyi	ぎぃ
gyu	ぎゅ
gye	ぎぇ
gyo	ぎょ

sha	しゃ
shi	し
shu	しゅ
she	しぇ
sho	しょ

swa	すぁ
swi	すぃ
swu	すぅ
swe	すぇ
swo	すぉ

sya	しゃ
syi	しぃ
syu	しゅ
sye	しぇ
syo	しょ

tha	てゃ
thi	てぃ
thu	てゅ
the	てぇ
tho	てょ

tsa	つぁ
tsi	つぃ
tsu	つ
tse	つぇ
tso	つぉ

twa	とぁ
twi	とぃ
twu	とぅ
twe	とぇ
two	とぉ

tya	ちゃ
tyi	ちぃ
tyu	ちゅ
tye	ちぇ
tyo	ちょ

dha	でゃ
dhi	でぃ
dhu	でゅ
dhe	でぇ
dho	でょ

nya	にゃ
nyi	にぃ
nyu	にゅ
nye	にぇ
nyo	にょ

hya	ひゃ
hyi	ひぃ
hyu	ひゅ
hye	ひぇ
hyo	ひょ

bya	びゃ
byi	びぃ
byu	びゅ
bye	びぇ
byo	びょ

pya	ぴゃ
pyi	ぴぃ
pyu	ぴゅ
pye	ぴぇ
pyo	ぴょ

mya	みゃ
myi	みぃ
myu	みゅ
mye	みぇ
myo	みょ

rya	りゃ
ryi	りぃ
ryu	りゅ
rye	りぇ
ryo	りょ

ca	か
ci	し
cu	く
ce	せ
co	こ

cha	ちゃ
chi	ち
chu	ちゅ
che	ちぇ
cho	ちょ

fa	ふぁ
fi	ふぃ
fu	ふ
fe	ふぇ
fo	ふぉ

fwa	ふぁ
fwi	ふぃ
fwu	ふぅ
fwe	ふぇ
fwo	ふぉ

fya	ふゃ
fyi	ふぃ
fyu	ふゅ
fye	ふぇ
fyo	ふょ

ja	じゃ
ji	じ
ju	じゅ
je	じぇ
jo	じょ

jya	じゃ
jyi	じぃ
jyu	じゅ
jye	じぇ
jyo	じょ

qa	くぁ
qi	くぃ
qu	く
qe	くぇ
qo	くぉ

qwa	くぁ
qwi	くぃ
qwu	くぅ
qwe	くぇ
qwo	くぉ

qya	くゃ
qyi	くぃ
qyu	くゅ
qye	くぇ
qyo	くょ

va	ヴぁ
vi	ヴぃ
vu	ヴ
ve	ヴぇ
vo	ヴぉ

vya	ヴゃ
vyi	ヴぃ
vyu	ヴゅ
vye	ヴぇ
vyo	ヴょ

nn	ん
n'	ん
xn	ん
ltu	っ
xtu	っ
lwa	ゎ
xwa	ゎ
lka	ヵ
xka	ヵ
lke	ヶ
xke	ヶ
kwa	くぁ

-	ー
~	～

mba	んば
mbi	んび
mbu	んぶ
mbe	んべ
mbo	んぼ

mpa	んぱ
mpi	んぴ
mpu	んぷ
mpe	んぺ
mpo	んぽ

mma	んま
mmi	んみ
mmu	んむ
mme	んめ
mmo	んも

tcha	っちゃ
tchi	っち
tchu	っちゅ
tche	っちぇ
tcho	っちょ

bb	っ	b
cc	っ	c
dd	っ	d
ff	っ	f
gg	っ	g
hh	っ	h
jj	っ	j
kk	っ	k
ll	っ	l
mm	っ	m
pp	っ	p
qq	っ	q
rr	っ	r
ss	っ	s
tt	っ	t
vv	っ	v
ww	っ	w
xx	っ	x
yy	っ	y
zz	っ	z

nb	ん	b
nc	ん	c
nd	ん	d
nf	ん	f
ng	ん	g
nh	ん	h
nj	ん	j
nk	ん	k
nl	ん	l
nm	ん	m
np	ん	p
nq	ん	q
nr	ん	r
ns	ん	s
nt	ん	t
nv	ん	v
nw	ん	w
nx	ん	x
ny	ん	y
nz	ん	z
